20 15
####################
#.....        ....*#
#.#.############.#.#
# #....      ....# #
# #.############.# #
#.#.......*......# #
#.#.#.########.#.#.#
#  .#====##....#. .#
#.#.#.########.#.#.#
#.#.....   ......#.#
# #.############.# #
# #....../.......# #
#.##############.#.#
#*.....       .....#
####################