20 6
####################
#                * #
#.# ###### ##### # #
#.#  #=#         # #
#.# ##.###.####### #
#.............../  #
####################