19 8
###################
#................*#
#.# #####.##### #.#
#.# #== #.#   # #.#
#.#   #  .  #   #.#
#.#######.#######.#
#................/#
###################