#################
#=#% # ### # %#=#
# ## #  #  # ## #
#       #       #
#=#### ### ####=#
###     #     ###
#       #       #
# ####  #  #### #
# ##### # ##### #
#*#.....#.....#*#
#.#.#.#...# # # #
#.#.#.#.#.# # # #
#.#.#.#.#.# # # #
#.#...#.#.# ..*.#
#.###...# # #.#.#
#...........#.#.#
#.####.####.#.#.#
#.....  \  .....#
#################