#################
# .....##...... #
#   .#====#.##  #
#   .######.##. #
#*  .... ...##. #
#######  ####   #
#         #     #
#    ## ### #####
#  ####..#  ....#
# .. #%..#  #####
#....####   ... #
# .. #  #  .....#
#  ### ####  .. #
#    # #... #   #
#    # #.*.#    #
#.#....####     #
#.#.#..#  ....  #
#.#..#.#  ....  #
###.#..#\ ....  #
#*...#.#  ....  #
#################